Anh chàng	Anh chàng
Anh nhân viên	Anh nhân viên
Anh thanh niên	Anh thanh niên
Ba người	Ba người
Ba người bạn	Ba người bạn
Ba người đàn ông	Ba người đàn ông
Bia	Bia
Bà mẹ	Bà mẹ
Bàn tay	Bàn tay
Bàn tay dính máu	Bàn tay dính máu
Bàn tay người trẻ	Bàn tay người trẻ
Bàn tay run	Bàn tay run
Bàn tay run rẩy	Bàn tay run rẩy
Bàn tay rớm máu	Bàn tay rớm máu
Bàn ăn	Bàn ăn
Bác sĩ	Bác sĩ
Bác sĩ thú y	Bác sĩ thú y
Bé gái	Bé gái
Bé trai	Bé trai
Bình đựng nước	Bình đựng nước
Bạn bè	Bạn bè
Bạn nữ	Bạn nữ
Bầu trời hoàng hôn	Bầu trời hoàng hôn
Bầu trời trong xanh	Bầu trời trong xanh
Bức tranh phong cảnh	Bức tranh phong cảnh
Bức tường	Bức tường
Bức tường trắng	Bức tường trắng
Bức ảnh chân dung	Bức ảnh chân dung
Ca sĩ	Ca sĩ
Cam kết	Cam kết
Camera	Camera
Chiếc bàn	Chiếc bàn
Chiếc bàn gỗ	Chiếc bàn gỗ
Chiếc bánh mì	Chiếc bánh mì
Chiếc bánh ngọt	Chiếc bánh ngọt
Chiếc bánh sandwich	Chiếc bánh sandwich
Chiếc ghế mây	Chiếc ghế mây
Chiếc laptop	Chiếc laptop
Chiếc ly nước cam	Chiếc ly nước cam
Chiếc xe	Chiếc xe
Chiếc điện thoại	Chiếc điện thoại
Chiếc đồng hồ	Chiếc đồng hồ
Chiến tranh	Chiến tranh
Chàng trai	Chàng trai
Chân chống xe máy	Chân chống xe máy
Chú chó	Chú chó
Chú chó con	Chú chó con
Chú mèo	Chú mèo
Clip	Clip
Clip dàn dựng	Clip dàn dựng
Clip hướng dẫn	Clip hướng dẫn
Clip khuyến khích	Clip khuyến khích
Clip mô phỏng	Clip mô phỏng
Clip mô tả	Clip mô tả
Clip người	Clip người
Clip người mẫu	Clip người mẫu
Clip người nổi tiếng	Clip người nổi tiếng
Clip người đàn ông	Clip người đàn ông
Clip quảng bá	Clip quảng bá
Clip quảng cáo	Clip quảng cáo
Con mèo	Con mèo
Con vật	Con vật
Cánh cửa	Cánh cửa
Cô giáo	Cô giáo
Cô gái	Cô gái
Cô gái bế mèo	Cô gái bế mèo
Cô gái mặc bikini	Cô gái mặc bikini
Cô gái mặc áo crop-top	Cô gái mặc áo crop-top
Cô gái mặc áo ngủ	Cô gái mặc áo ngủ
Cô gái mở laptop	Cô gái mở laptop
Cô gái ăn kem	Cô gái ăn kem
Cô lễ tân	Cô lễ tân
Cô nhân viên	Cô nhân viên
Cô nhân viên lễ tân	Cô nhân viên lễ tân
Cô nhân viên pha chế	Cô nhân viên pha chế
Công tắc thông minh	Công tắc thông minh
Cảnh	Cảnh
Cảnh chiếu	Cảnh chiếu
Cảnh hai nhân vật	Cảnh hai nhân vật
Cảnh người mẫu	Cảnh người mẫu
Cảnh phá cửa	Cảnh phá cửa
Cảnh quay	Cảnh quay
Cảnh tiệc cưới	Cảnh tiệc cưới
Cảnh tiệc sinh nhật	Cảnh tiệc sinh nhật
Cầu thủ	Cầu thủ
Cận cảnh	Cận cảnh
Cận cảnh bàn tay	Cận cảnh bàn tay
Cận cảnh chai nước suối lạnh	Cận cảnh chai nước suối lạnh
Cận cảnh khuôn mặt	Cận cảnh khuôn mặt
Cận cảnh ly cà phê	Cận cảnh ly cà phê
Cận cảnh miếng bánh pizza	Cận cảnh miếng bánh pizza
Cận cảnh ngọn lửa	Cận cảnh ngọn lửa
Cận cảnh đôi môi run rẩy	Cận cảnh đôi môi run rẩy
Cận cảnh đôi mắt	Cận cảnh đôi mắt
Cận mặt cô gái	Cận mặt cô gái
Cặp vợ chồng	Cặp vợ chồng
Cặp đôi	Cặp đôi
Cặp đôi già	Cặp đôi già
Diễn viên	Diễn viên
Drone	Drone
Dòng chữ	Dòng chữ
Em bé	Em bé
Gameplay	Gameplay
Gia sư	Gia sư
Gia đình	Gia đình
Gia đình bốn người	Gia đình bốn người
Gia đình trẻ	Gia đình trẻ
Giao diện	Giao diện
Giáo viên	Giáo viên
Gió	Gió
Giảng viên	Giảng viên
Giọng nói	Giọng nói
Giọng nữ	Giọng nữ
Giọng thuyết minh	Giọng thuyết minh
Giọng đọc	Giọng đọc
Giọt dầu massage	Giọt dầu massage
Giọt dầu xả tóc	Giọt dầu xả tóc
Gương chiếu hậu xe đạp	Gương chiếu hậu xe đạp
Gương mặt	Gương mặt
Hai bạn trẻ	Hai bạn trẻ
Hai chàng trai	Hai chàng trai
Hai cô gái	Hai cô gái
Hai người	Hai người
Hai người chơi	Hai người chơi
Hai người đàn ông	Hai người đàn ông
Hai thanh niên	Hai thanh niên
Hai đấu sĩ	Hai đấu sĩ
Hai đứa trẻ	Hai đứa trẻ
Hành động	Hành động
Hình ảnh	Hình ảnh
Hình ảnh bàn ăn	Hình ảnh bàn ăn
Hình ảnh bát cháo	Hình ảnh bát cháo
Hình ảnh bát phở	Hình ảnh bát phở
Hình ảnh chai nước hoa	Hình ảnh chai nước hoa
Hình ảnh con phố	Hình ảnh con phố
Hình ảnh cánh đồng	Hình ảnh cánh đồng
Hình ảnh màn hình	Hình ảnh màn hình
Hình ảnh đồ uống	Hình ảnh đồ uống
Hệ thống treo ô tô	Hệ thống treo ô tô
Họa sĩ	Họa sĩ
Học sinh	Học sinh
Khuôn mặt	Khuôn mặt
Khuôn mặt cận cảnh	Khuôn mặt cận cảnh
Khuôn mặt người già	Khuôn mặt người già
Khách du lịch	Khách du lịch
Khách hàng	Khách hàng
Kiến trúc sư	Kiến trúc sư
Kỹ sư	Kỹ sư
Kỹ thuật viên	Kỹ thuật viên
Livestream	Livestream
Logo bia	Logo bia
Logo thương hiệu	Logo thương hiệu
Logo thương hiệu bia	Logo thương hiệu bia
Ly bia	Ly bia
Ly bia bọt	Ly bia bọt
Ly rượu vang đỏ	Ly rượu vang đỏ
Lời hứa	Lời hứa
MC	MC
Màn hình ứng dụng ngân hàng	Màn hình ứng dụng ngân hàng
Máu	Máu
Máy bay	Máy bay
Máy chiếu phim	Máy chiếu phim
Máy hút bụi cầm tay	Máy hút bụi cầm tay
Máy in ảnh di động	Máy in ảnh di động
Máy làm bánh kem	Máy làm bánh kem
Máy làm bánh mì	Máy làm bánh mì
Máy làm bánh waffle	Máy làm bánh waffle
Máy làm kem cứng	Máy làm kem cứng
Máy làm tóc duỗi nhiệt độ cao	Máy làm tóc duỗi nhiệt độ cao
Máy làm tóc uốn lượn tự động	Máy làm tóc uốn lượn tự động
Máy làm tóc xoăn tự động	Máy làm tóc xoăn tự động
Máy lọc nước	Máy lọc nước
Máy pha cà phê	Máy pha cà phê
Máy pha cà phê tự động	Máy pha cà phê tự động
Máy quay	Máy quay
Máy rửa chén	Máy rửa chén
Máy sưởi điện	Máy sưởi điện
Máy tính bảng	Máy tính bảng
Máy tính bỏ túi	Máy tính bỏ túi
Máy tạo kiểu tóc dập xù	Máy tạo kiểu tóc dập xù
Máy tạo kiểu tóc uốn cụp	Máy tạo kiểu tóc uốn cụp
Máy xay cà phê điện	Máy xay cà phê điện
Máy đếm tiền	Máy đếm tiền
Máy ảnh	Máy ảnh
Mô phỏng	Mô phỏng
Mọi người	Mọi người
Một anh chàng	Một anh chàng
Một biểu đồ	Một biểu đồ
Một bàn tay	Một bàn tay
Một bình hoa	Một bình hoa
Một bóng người	Một bóng người
Một bóng đen	Một bóng đen
Một bông hoa	Một bông hoa
Một bông hoa cúc vàng	Một bông hoa cúc vàng
Một bức tranh	Một bức tranh
Một bức tường	Một bức tường
Một bức ảnh	Một bức ảnh
Một bức ảnh chân dung	Một bức ảnh chân dung
Một chai thuốc không nhãn mác	Một chai thuốc không nhãn mác
Một chiếc bánh kem	Một chiếc bánh kem
Một chiếc bánh kem nhỏ	Một chiếc bánh kem nhỏ
Một chiếc bánh mì	Một chiếc bánh mì
Một chiếc bánh mì nóng hổi	Một chiếc bánh mì nóng hổi
Một chiếc bánh ngọt	Một chiếc bánh ngọt
Một chiếc bóng	Một chiếc bóng
Một chiếc ghế	Một chiếc ghế
Một chiếc ghế gỗ	Một chiếc ghế gỗ
Một chiếc ghế mây	Một chiếc ghế mây
Một chiếc ghế sofa	Một chiếc ghế sofa
Một chiếc laptop	Một chiếc laptop
Một chiếc ly	Một chiếc ly
Một chiếc ly thủy tinh	Một chiếc ly thủy tinh
Một chiếc đồng hồ	Một chiếc đồng hồ
Một chiếc đồng hồ báo thức	Một chiếc đồng hồ báo thức
Một chiếc đồng hồ treo tường	Một chiếc đồng hồ treo tường
Một chàng trai	Một chàng trai
Một chén cơm	Một chén cơm
Một chén cơm nóng	Một chén cơm nóng
Một chén súp	Một chén súp
Một chén trà	Một chén trà
Một chú chó nhỏ	Một chú chó nhỏ
Một chú mèo	Một chú mèo
Một chậu cây	Một chậu cây
Một chậu cây cảnh	Một chậu cây cảnh
Một chậu cây nhỏ	Một chậu cây nhỏ
Một chậu hoa	Một chậu hoa
Một chậu hoa nhỏ	Một chậu hoa nhỏ
Một con chim	Một con chim
Một con chó	Một con chó
Một con chó con	Một con chó con
Một con mèo	Một con mèo
Một con mèo nhỏ	Một con mèo nhỏ
Một cây bút	Một cây bút
Một cây bút chì	Một cây bút chì
Một cô gái	Một cô gái
Một cô gái trẻ	Một cô gái trẻ
Một cơn gió	Một cơn gió
Một cậu bé	Một cậu bé
Một cậu thanh niên	Một cậu thanh niên
Một cốc cà phê bốc khói	Một cốc cà phê bốc khói
Một cốc trà xanh	Một cốc trà xanh
Một dòng chữ	Một dòng chữ
Một dòng chữ cảnh báo nhỏ	Một dòng chữ cảnh báo nhỏ
Một dòng chữ nhỏ	Một dòng chữ nhỏ
Một dòng chữ thắng lớn mỗi ngày	Một dòng chữ thắng lớn mỗi ngày
Một dòng chữ “làm giàu nhanh”	Một dòng chữ “làm giàu nhanh”
Một gia đình	Một gia đình
Một gương mặt mờ nhòe	Một gương mặt mờ nhòe
Một khuôn mặt	Một khuôn mặt
Một ly nước	Một ly nước
Một ly nước cam	Một ly nước cam
Một ly nước lọc	Một ly nước lọc
Một ly nước ép cam	Một ly nước ép cam
Một ly sinh tố dâu	Một ly sinh tố dâu
Một lọ chất lỏng	Một lọ chất lỏng
Một màn hình	Một màn hình
Một màn hình máy tính	Một màn hình máy tính
Một người	Một người
Một người phụ nữ	Một người phụ nữ
Một người trẻ	Một người trẻ
Một người đàn ông	Một người đàn ông
Một người đàn ông lạ mặt	Một người đàn ông lạ mặt
Một người đàn ông mặc vest	Một người đàn ông mặc vest
Một ngọn nến	Một ngọn nến
Một nhóm bạn	Một nhóm bạn
Một nhóm người	Một nhóm người
Một nhóm thanh niên	Một nhóm thanh niên
Một nhóm đàn ông	Một nhóm đàn ông
Một nhóm đối tượng	Một nhóm đối tượng
Một nụ cười	Một nụ cười
Một phong bì	Một phong bì
Một phong bì dày	Một phong bì dày
Một phong bì tiền	Một phong bì tiền
Một phong bì trắng dày	Một phong bì trắng dày
Một quyển sách	Một quyển sách
Một quyển sổ	Một quyển sổ
Một quyển sổ ghi chú	Một quyển sổ ghi chú
Một thanh niên	Một thanh niên
Một tách cà phê	Một tách cà phê
Một tách trà	Một tách trà
Một tách trà bốc hơi	Một tách trà bốc hơi
Một tách trà gừng	Một tách trà gừng
Một tách trà nóng	Một tách trà nóng
Một tấm biển “kiếm tiền ngay hôm nay”	Một tấm biển “kiếm tiền ngay hôm nay”
Một tấm bản đồ	Một tấm bản đồ
Một tấm bảng	Một tấm bảng
Một tấm bảng điện tử	Một tấm bảng điện tử
Một tấm ảnh	Một tấm ảnh
Một tờ báo	Một tờ báo
Một tờ giấy	Một tờ giấy
Một tờ giấy chứng nhận giả	Một tờ giấy chứng nhận giả
Một tờ giấy ghi “bán nợ nhanh”	Một tờ giấy ghi “bán nợ nhanh”
Một tờ giấy ghi “bán đất gấp”	Một tờ giấy ghi “bán đất gấp”
Một tờ hóa đơn	Một tờ hóa đơn
Một tờ hóa đơn chưa thanh toán	Một tờ hóa đơn chưa thanh toán
Một tờ hóa đơn điện tử	Một tờ hóa đơn điện tử
Một tờ rơi	Một tờ rơi
Một vật thể	Một vật thể
Một đứa trẻ	Một đứa trẻ
Nam MC	Nam MC
Nam ca sĩ	Nam ca sĩ
Nam chính	Nam chính
Nam diễn viên	Nam diễn viên
Nam người mẫu	Nam người mẫu
Nam nhân vật	Nam nhân vật
Nam sinh	Nam sinh
Nam thanh niên	Nam thanh niên
Nghệ sĩ	Nghệ sĩ
Ngôn từ	Ngôn từ
Người	Người
Người bán	Người bán
Người bán hàng	Người bán hàng
Người bán hàng online	Người bán hàng online
Người bị hất đồ	Người bị hất đồ
Người bị kéo	Người bị kéo
Người bị lôi	Người bị lôi
Người bị tát	Người bị tát
Người bị tát mạnh	Người bị tát mạnh
Người cha	Người cha
Người cha và con trai	Người cha và con trai
Người chơi	Người chơi
Người có ảnh hưởng	Người có ảnh hưởng
Người cầm dao	Người cầm dao
Người dùng	Người dùng
Người dẫn	Người dẫn
Người dẫn chuyện	Người dẫn chuyện
Người dẫn chương trình	Người dẫn chương trình
Người dẫn chương trình livestream	Người dẫn chương trình livestream
Người giao hàng	Người giao hàng
Người già	Người già
Người kỹ sư	Người kỹ sư
Người leo núi	Người leo núi
Người lái taxi	Người lái taxi
Người lái xe	Người lái xe
Người lái xe buýt	Người lái xe buýt
Người mẫu	Người mẫu
Người mẫu cúi người	Người mẫu cúi người
Người mẫu cởi áo	Người mẫu cởi áo
Người mẫu khoe eo khi	Người mẫu khoe eo khi
Người mẫu mặc bikini	Người mẫu mặc bikini
Người mẫu mặc bikini trắng	Người mẫu mặc bikini trắng
Người mẫu mặc váy bó sát	Người mẫu mặc váy bó sát
Người mẫu mặc váy mỏng	Người mẫu mặc váy mỏng
Người mẫu mặc váy ngắn	Người mẫu mặc váy ngắn
Người mẫu mặc váy ngủ ren	Người mẫu mặc váy ngủ ren
Người mẫu mặc váy ngủ trắng	Người mẫu mặc váy ngủ trắng
Người mẫu mặc váy ren đen	Người mẫu mặc váy ren đen
Người mẫu mặc áo hai dây	Người mẫu mặc áo hai dây
Người mẫu mặc áo lưới	Người mẫu mặc áo lưới
Người mẫu mặc áo lưới đen	Người mẫu mặc áo lưới đen
Người mẫu mặc áo mỏng	Người mẫu mặc áo mỏng
Người mẫu mặc áo ngủ	Người mẫu mặc áo ngủ
Người mẫu mặc áo ngủ bó sát	Người mẫu mặc áo ngủ bó sát
Người mẫu mặc áo ngủ mỏng	Người mẫu mặc áo ngủ mỏng
Người mẫu mặc áo ngủ ren trắng	Người mẫu mặc áo ngủ ren trắng
Người mẫu mặc áo ren	Người mẫu mặc áo ren
Người mẫu mặc áo ren đen	Người mẫu mặc áo ren đen
Người mẫu mặc áo trong suốt	Người mẫu mặc áo trong suốt
Người mẫu mặc áo xuyên thấu	Người mẫu mặc áo xuyên thấu
Người mẫu mặc đồ lót	Người mẫu mặc đồ lót
Người mẫu mặc đồ ngủ	Người mẫu mặc đồ ngủ
Người mẫu mặc đồ ren	Người mẫu mặc đồ ren
Người mẫu nam	Người mẫu nam
Người mẫu nghiêng người	Người mẫu nghiêng người
Người mẫu nằm	Người mẫu nằm
Người mẫu nằm nghiêng	Người mẫu nằm nghiêng
Người mẫu nằm ngửa	Người mẫu nằm ngửa
Người mẫu nằm sấp	Người mẫu nằm sấp
Người mẫu nằm trên giường	Người mẫu nằm trên giường
Người mẫu nữ	Người mẫu nữ
Người mẫu tạo dáng	Người mẫu tạo dáng
Người mẫu đứng	Người mẫu đứng
Người mẹ	Người mẹ
Người nông dân	Người nông dân
Người nổi tiếng	Người nổi tiếng
Người pha chế	Người pha chế
Người phụ nữ	Người phụ nữ
Người phụ nữ khẽ	Người phụ nữ khẽ
Người phụ nữ trung niên	Người phụ nữ trung niên
Người thanh niên	Người thanh niên
Người thợ	Người thợ
Người thợ cắt tóc	Người thợ cắt tóc
Người thợ điện	Người thợ điện
Người trẻ	Người trẻ
Người tài xế	Người tài xế
Người tự xưng bác sĩ	Người tự xưng bác sĩ
Người đàn ông	Người đàn ông
Người đàn ông cười	Người đàn ông cười
Người đàn ông say xỉn	Người đàn ông say xỉn
Người đàn ông trung niên	Người đàn ông trung niên
Người đầu bếp	Người đầu bếp
Nhà khoa học	Nhà khoa học
Nhà nghiên cứu	Nhà nghiên cứu
Nhà đầu tư trẻ	Nhà đầu tư trẻ
Nhân viên	Nhân viên
Nhân viên IT	Nhân viên IT
Nhân viên bán hàng	Nhân viên bán hàng
Nhân viên chăm sóc khách hàng	Nhân viên chăm sóc khách hàng
Nhân viên giao hàng	Nhân viên giao hàng
Nhân viên kỹ thuật	Nhân viên kỹ thuật
Nhân viên lễ tân	Nhân viên lễ tân
Nhân viên ngân hàng	Nhân viên ngân hàng
Nhân viên pha chế	Nhân viên pha chế
Nhân viên siêu thị	Nhân viên siêu thị
Nhân viên trẻ	Nhân viên trẻ
Nhân viên văn phòng	Nhân viên văn phòng
Nhân viên y tế	Nhân viên y tế
Nhân vật	Nhân vật
Nhân vật chính	Nhân vật chính
Nhân vật game	Nhân vật game
Nhân vật nữ	Nhân vật nữ
Nhóm bạn	Nhóm bạn
Nhóm bạn nam	Nhóm bạn nam
Nhóm bạn trai	Nhóm bạn trai
Nhóm bạn trẻ	Nhóm bạn trẻ
Nhóm học sinh	Nhóm học sinh
Nhóm nhân viên	Nhóm nhân viên
Nhóm sinh viên	Nhóm sinh viên
Nhóm thanh niên	Nhóm thanh niên
Nhóm đồng nghiệp	Nhóm đồng nghiệp
Nhạc sĩ	Nhạc sĩ
Nội dung	Nội dung
Quảng cáo	Quảng cáo
Quảng cáo app	Quảng cáo app
Quảng cáo app chỉnh ảnh	Quảng cáo app chỉnh ảnh
Quảng cáo app hẹn hò	Quảng cáo app hẹn hò
Quảng cáo app soi cầu bóng đá	Quảng cáo app soi cầu bóng đá
Quảng cáo app soi cầu xổ số	Quảng cáo app soi cầu xổ số
Quảng cáo bia	Quảng cáo bia
Quảng cáo dịch vụ cờ bạc online	Quảng cáo dịch vụ cờ bạc online
Quảng cáo game	Quảng cáo game
Quảng cáo game chiến đấu	Quảng cáo game chiến đấu
Quảng cáo game hành động	Quảng cáo game hành động
Quảng cáo game sinh tồn	Quảng cáo game sinh tồn
Quảng cáo laptop	Quảng cáo laptop
Quảng cáo nước hoa	Quảng cáo nước hoa
Quảng cáo rượu	Quảng cáo rượu
Quảng cáo sản phẩm nước hoa	Quảng cáo sản phẩm nước hoa
Quảng cáo sản phẩm tăng cường sinh lý nam	Quảng cáo sản phẩm tăng cường sinh lý nam
Quảng cáo thuốc	Quảng cáo thuốc
Quảng cáo thực phẩm chức năng	Quảng cáo thực phẩm chức năng
Quảng cáo trò chơi	Quảng cáo trò chơi
Quảng cáo điện thoại	Quảng cáo điện thoại
Quảng cáo ứng dụng	Quảng cáo ứng dụng
Quảng cáo ứng dụng học tiếng Anh	Quảng cáo ứng dụng học tiếng Anh
Robot hút bụi	Robot hút bụi
Rắn	Rắn
Sinh viên	Sinh viên
Streamer	Streamer
Tai nghe	Tai nghe
Tay	Tay
Thanh niên	Thanh niên
Thầy cúng	Thầy cúng
Thầy pháp	Thầy pháp
Thợ lặn	Thợ lặn
Trưởng nhóm	Trưởng nhóm
Trưởng phòng	Trưởng phòng
Trẻ em	Trẻ em
Tờ giấy	Tờ giấy
Tờ giấy hướng dẫn	Tờ giấy hướng dẫn
Tờ giấy nhỏ	Tờ giấy nhỏ
Tờ hóa đơn	Tờ hóa đơn
Tờ hướng dẫn	Tờ hướng dẫn
Video	Video
Video cắt ghép	Video cắt ghép
Video cố tình	Video cố tình
Video dàn dựng	Video dàn dựng
Video dạy	Video dạy
Video dạy học	Video dạy học
Video dạy kỹ năng	Video dạy kỹ năng
Video game	Video game
Video hướng dẫn	Video hướng dẫn
Video khuyến khích	Video khuyến khích
Video khuyến mãi	Video khuyến mãi
Video mô phỏng	Video mô phỏng
Video mô tả	Video mô tả
Video người nổi tiếng	Video người nổi tiếng
Video nói	Video nói
Video quảng bá	Video quảng bá
Video quảng bá game	Video quảng bá game
Video quảng bá game sinh tồn	Video quảng bá game sinh tồn
Video quảng cáo	Video quảng cáo
Video quảng cáo dịch vụ	Video quảng cáo dịch vụ
Video quảng cáo game	Video quảng cáo game
Video quảng cáo game bắn súng	Video quảng cáo game bắn súng
Video quảng cáo game chiến thuật	Video quảng cáo game chiến thuật
Video quảng cáo thuốc giảm cân	Video quảng cáo thuốc giảm cân
Video quảng cáo ứng dụng	Video quảng cáo ứng dụng
Váy cô gái	Váy cô gái
Vũ công	Vũ công
Vận động viên	Vận động viên
Xe	Xe
Xe máy điện	Xe máy điện
Xác cá	Xác cá
Xác động vật	Xác động vật
Ánh nắng	Ánh nắng
Ánh nắng buổi sáng	Ánh nắng buổi sáng
Ánh nắng nhẹ	Ánh nắng nhẹ
Ánh sáng	Ánh sáng
Ánh sáng ban mai	Ánh sáng ban mai
Ánh sáng buổi chiều	Ánh sáng buổi chiều
Ánh sáng buổi sáng	Ánh sáng buổi sáng
Ánh sáng buổi trưa	Ánh sáng buổi trưa
Ánh sáng bình minh	Ánh sáng bình minh
Ánh sáng chiều	Ánh sáng chiều
Ánh sáng dịu	Ánh sáng dịu
Ánh sáng lung linh	Ánh sáng lung linh
Ánh sáng mặt trời	Ánh sáng mặt trời
Ánh sáng mờ	Ánh sáng mờ
Ánh sáng nhẹ	Ánh sáng nhẹ
Ánh sáng trắng	Ánh sáng trắng
Ánh sáng từ màn hình	Ánh sáng từ màn hình
Ánh sáng từ màn hình điện thoại	Ánh sáng từ màn hình điện thoại
Ánh sáng vàng	Ánh sáng vàng
Ánh sáng xanh	Ánh sáng xanh
Ánh sáng yếu	Ánh sáng yếu
Ánh sáng đỏ	Ánh sáng đỏ
Ánh sáng ấm	Ánh sáng ấm
Ánh sáng ấm áp	Ánh sáng ấm áp
Ánh đèn mờ	Ánh đèn mờ
Ánh đèn xanh	Ánh đèn xanh
Ánh đèn đỏ	Ánh đèn đỏ
Ô tô	Ô tô
Ông bố	Ông bố
Ông thầy	Ông thầy
Điện thoại di động	Điện thoại di động
Đoàn tàu	Đoàn tàu
Đoạn clip	Đoạn clip
Đám khói mờ	Đám khói mờ
Đám đông	Đám đông
Đèn bàn	Đèn bàn
Đèn chiếu sáng ban ngày DRL ô tô	Đèn chiếu sáng ban ngày DRL ô tô
Đôi bàn tay	Đôi bàn tay
Đôi bạn	Đôi bạn
Đôi bạn trẻ	Đôi bạn trẻ
Đôi giày mới	Đôi giày mới
Đôi giày thể thao	Đôi giày thể thao
Đôi môi người đàn ông	Đôi môi người đàn ông
Đôi mắt	Đôi mắt
Đôi mắt người trung niên	Đôi mắt người trung niên
Đôi mắt người đàn ông	Đôi mắt người đàn ông
Đôi tay	Đôi tay
Đôi tay run rẩy	Đôi tay run rẩy
Đầu bếp	Đầu bếp
Ống kính	Ống kính
